word	1) слово  2)  речь, разговор, слова  3)  размолвка, ссора  4) замечание, совет  5)  вести, известие, сообщение  6)  обещание, заверение  7) рекомендация, совет  8)  приказ, приказание  9) пароль, пропуск 
takeover	1) перенимать  2) захват  3) переворот  4) овладение  5) вступление во владение
nurture	1) воспитание, обучение  2)  выращивание, выведение   3) питание, кормление  4) пища, еда, корм   5) воспитывать, обучать  6)  выращивать, выводить   7) лелеять, питать , вынашивать 
mankind	1) человечество, человеческий род  2) мужчины, мужской пол
obesity	тучность, ожирение, чрезмерная полнота
scenery	1)  декорации  2) обстановка, окружение  3) пейзаж, ландшафт, вид
outbreak	1) взрыв, вспышка   2) начало   3) вспышка   4) массовое появление   5) мятеж, бунт, волнения  6)  выброс, выход 
weak-willed	бесхарактерный
vulgar	1)    толпа, чернь  2) вульгарный, грубый, развязный, противоречащий общепринятым нормам поведения  3) лишенный тонкости, изящества, пошлый, мещанский  4) неоригинальный, заурядный, избитый, тривиальный  5) относящийся к простым людям  6) народный, общенародный, национальный, родной   7) широко распространенный 
vengeful	1) мстительный  2) мстящий
trustworthy	1) заслуживающий доверия, надежный  2) точный, соответствующий действительности 
tidy	1) опрятный, аккуратный, чистый  2)  значительный, приличный, порядочный  3)  в хорошем состоянии, приятный на вид, здоровый, цветущий, толстый, пухленький  4) в грам. знач. нареч.: опрятно, чисто  5)  прибирать, приводить в порядок  6) прибираться  7) убирать, ставить на место   8) мешочек для лоскутов и всякой всячины  9) салфеточка  
reliable	1) надежный  2) заслуживающий доверия, достоверный  3)  надежный в работе или эксплуатации
unkind	1) недобрый, злой  2)   немягкий, суровый 
truculent	1) свирепый, жестокий  2) агрессивный, воинственный  3) разрушительный, смертоносный  4) грубый, резкий, язвительный   5) вызывающий, агрессивный   6) низкий, продажный
thoughtless	1) бездумный, беспечный, неосмотрительный, неразумный, неосторожный  2) не думающий, не подумавший  3)  не думающий, не подозревающий, не ведающий   4) глупый  5)  невнимательный , эгоистичный
touchy	1) обидчивый, раздражительный  2) повышенно чувствительный  3) щекотливый, деликатный  4) больной, наболевший  5) рискованный, опасный  6) легковоспламеняющийся  7) сделанный мелкими штрихами
timid	1) застенчивый, неуверенный, робкий  2) пугливый 
tactless	бестактный
superficial	1) поверхностный, неглубокий  2) поверхностный, несерьезный, неосновательный  3) внешний, кажущийся  4)  наносный, аллювиальный  5)  двухмерный
stubborn	1) упрямый, неподатливый  2) упорный  3) тяжелый, неподатливый 
stingy	1) жалящий  2) скупой, скаредный  3) скудный, ограниченный
sneaky	1) подлый  2) трусливый  3) раболепный, угодливый
silly	1)  глупыш, несмышленыш  2) неумный, неразумный, глупый  3)  одуревший, ничего не соображающий   4)  влюбленный по уши  5)  слабый, болезненный, беспомощный  6)  жалкий, ничтожный  7)  слабоумный, умственно отсталый  8) оглушать, ошеломлять
self-indulgent	потворствующий, потакающий своим желаниям
self-centered	эгоцентричный
selfish	эгоистичный, эгоистический, себялюбивый
secretive	скрытный, замкнутый
sarcastic	саркастический, насмешливый, язвительный, колкий
resentful	1) обиженный, возмущенный  2) обидчивый
quick-tempered	вспыльчивый, раздражительный
quarrelsome	вздорный, придирчивый, задиристый, сварливый
pusillanimous	 малодушный, трусливый
pessimistic, pessimistical	пессимистический
perverse	1) порочный, извращенный, испорченный  2) упрямый, упорствующий   3) несговорчивый, капризный, своенравный  4) неправильный, нарушающий нормы  5) превратный, ошибочный
patronize	1) покровительствовать, опекать  2) относиться свысока, покровительственно, снисходительно  3)  оказывать частную финансовую поддержку   4)  быть постоянным посетителем, клиентом
parsimonious	1) бережливый, экономный, скупой  2) жалкий, бедный, скудный
obstinate	1) настойчивый, упорный, упрямый, не поддающийся , не прислушивающийся   2) трудно контролируемый, едва сдерживаемый  3) трудноизлечимый 
obsessive	одержимый навязчивой идеей, желанием
naughty	1) непослушный, шаловливый, капризный  2) дурной, гадкий   3)  рискованный, сомнительный  4)  порочный, греховный, испорченный  5)  плохой, худой
narrow-minded	ограниченный, узкий, недалекий, узколобый, с предрассудками
moody	1) легко поддающийся переменам настроения  2) унылый, угрюмый  3) со скверным характером
miserly	скупой, скаредный
materialistic, materialistical	материалистический
Machiavellian	1) последователь принципов Макиавелли  2) беспринципный политик  3) макиавеллиевский, макиавеллистический  4) хитроумный, бессовестный, бесчестный, беспринципный
intolerant	1) нетерпимый человек, фанатик  2) нетерпимый, фанатичный, не проявляющий терпимости к чужому мнению, вероисповеданию и т. п.  3) не проявляющий выносливости
interfering	вмешивающийся, мешающий, назойливый
interfere	1)  мешать, служить препятствием, помехой, чинить препятствия, помехи  2) вредить, причинять вред, наносить ущерб, портить  3)  изнасиловать  4)  вмешиваться, вторгаться   5) надоедать, докучать   6) сталкиваться, противоречить друг другу  7)   оспаривать  права на патент  8)  засекаться   9)  неправильно блокировать противника  
inflexible	1) негибкий, несгибаемый, негнущийся, жесткий  2) непреклонный, непоколебимый, неумолимый  3) неизменяемый, неизменный
indiscreet	1) нескромный, несдержанный  2) неблагоразумный, неосторожный, опрометчивый
indecisive	1) нерешающий, неокончательный  2) нерешительный, колеблющийся  3)  неясный, неопределенный
inconsistent	1) несовместимый, не соответствующий, противоречащий чему-либо  2) непоследовательный, противоречивый  3) неустойчивый, изменчивый
inconsiderate	1) невнимательный , не считающийся с остальными  2) необдуманный, неосмотрительный, опрометчивый, непродуманный, невзвешенный
impulsive	1) импульсивный, легко поддающийся воздействию  2) побуждающий, толкающий, движущий
harsh	1) грубый , жесткий, шероховатый  2) зазубренный  3) резкий, неприятный   4) режущий глаз, ядовитый, раздражающий   5) суровый, резкий   6) резкий, порывистый   7) грубый, резкий   8) строгий, суровый, жестокий
gullible	легковерный, доверчивый
grumpy	сердитый, сварливый, раздражительный
fussy	1) суетливый, нервный  2) перегруженный деталями, аляповатый  3) разборчивый  
foolhardy	безрассудно храбрый, отчаянный, любящий ненужный риск
foolish	1) глупый, безрассудный, взбалмошный  2) дурацкий, нелепый  3) слабоумный
flirtatious	кокетливый, любящий пофлиртовать
finicky	 разборчивый, придирчивый, мелочно-требовательный, на него не угодишь
domineering	1) деспотический, властный, не допускающий возражений  2) высокомерный  3) господствующий, возвышающийся , командный
dogmatic	1) догматический, доктринерский  2) категорический, безапелляционный  3) высокомерный, излишне самоуверенный  4)  дидактический
detached	1) отдельный, обособленный, стоящий особняком  2) оторванный, несвязанный  3) отдельный, выполняющий самостоятельную задачу  4) беспристрастный, непредубежденный, независимый  5)  командированный  6)  отжатый
deceitful	1) лживый, вероломный, предательский, обманный  2) вводящий в заблуждение, обманчивый
cynical	циничный, бесстыдный
cunningly	1) хитро  2) ловко
cunning	1) хитрость, коварство, лукавство  2)  уменье, ловкость, искусство  3) коварный, хитрый, лукавый  4) искусно сделанный  5)   прелестный, привлекательный, интересный, пикантный  6)  умелый, ловкий
cruel	1) жестокий, безжалостный, бессердечный  2) мучительный, ужасный, жестокий  3)  очень, чрезвычайно, чертовски  4)   портить, губить, лишать шансов на успех
cowardly	1) трусливый, малодушный  2)  трусливо, малодушно
compulsive	1)  человек, испытывающий непреодолимое влечение к чему-д, большой, страдающий навязчивыми состояниями  2) обязательный   3) принудительный, связанный с принуждением  4)  непреодолимый, навязчивый, маниакальный  5)  страдающий навязчивой идеей, непреодолимым влечением
careless	1) небрежный, невнимательный  2) неаккуратный, неточный  3) беспечный, беззаботный, легкомысленный  4)  не думающий , пренебрегающий   5) безыскусственный, естественный
cantankerous	сварливый, придирчивый, вздорный, неуживчивый
callousness	бессердечность, бездушие, бесчувственность, нечуткость, грубость 
callous	1) мозолистый, огрубелый, жесткий   2) бессердечный, бесчувственный, нечуткий  3) делать грубым, бесчувственным, огрублять  4) огрубляться, становиться грубым, бесчувственным
bossy	1)  распоряжающийся, заправляющий всем  2)   корова  3)   мясо  4) украшенный барельефами, выпуклый
bitchy	стервозный, поганый
belligerence	1) воинственность  2) состояние войны
insolent	1) нахал, грубиян  2) высокомерный, надменный, пренебрежительный, презрительный  3) наглый, дерзкий, нахальный, вызывающий
arrogant	1) высокомерный, надменный, заносчивый, самонадеянный  2) наглый, бесцеремонный
reserved	1) запасный, запасной, резервный  2) заказанный заранее  3) скрытный  4) сдержанный, замкнутый
quick-wittedly	1) находчиво, сообразительно  2) остроумно
quick-witted	1) находчивый, сообразительный  2) остроумный
plucky	1)  смелый, отважный, решительный  2)  четкий, отчетливый
placid	спокойный, мирный, безмятежный
pioneer	1) пионер, первоткрыватель, первопроходец  2) зачинатель, инициатор  3) новатор  4)  сапер  5)  пионер   6)  пионер   7)   название серии американских автоматических космических аппаратов   8) первый  9) новый, новаторский 
pioneering	1) изыскания, изыскательские работы  2)  подъем нови, вспашка целины  3) мелиорирование 
persistently	1) настойчиво  2) устойчиво
persistent	1) упорный, настойчивый  2) стойкий, устойчивый, постоянный  3) постоянный   4) неопадающий   5)  непрерывно возобновляющийся 
gregarious	1) стадный, стайный, ходящий, живущий стадами, стаями  2) общительный  3) стадный
convincingly	убедительно
convincing	убедительный
convince	1) убеждать, уверять  2)  убедить , довести до чьего-л. сознания
persuade	1) убеждать, склонять, уговаривать  2) вдавливать, втискивать
persuasiveness	убедительность
persuasively	убедительно
persuasive	1)  побуждение, мотив, стимул  2) убедительный
forceful	1) сильный, мощный  2) сильный, волевой  3) действенный, убедительный
ruth	 милосердие, сострадание, жалость, раскаяние, горе, печаль
ruthless	безжалостный, жестокий
impartiality	беспристрастность, непредвзятость, справедливость
impartially	беспристрастно
impartial	беспристрастный, непредвзятый, справедливый
fair-mindedness	1) справедливость  2) беспристрастность
fair-minded	справедливый, беспристрастный, непредубежденный
exuberant	1) роскошный, обильный, буйный   2) бьющий через край, бьющий ключом, неудержимый  3) излишний, избыточный  4) пышный, цветистый   5) цветущий 
determined	1) решительный, полный решимости, непреклонный  2) определенный, установленный
discreetness	1) сдержанность  2) осторожность  3) осмотрительность
discreetly	осторожно, осмотрительно, благоразумно, сдержанно
discreet	осторожный, осмотрительный, рассудительный, благоразумный, сдержанный, скромный
diligently	прилежно, усердно, старательно, с усердием
diligent	1) прилежный, усердный, старательный  2) неустанный, кропотливый   3)  внимательный, заботливый
courteous	вежливый, учтивый, любежный, обходительный
festivity	1) веселье, праздничность, праздничное, веселое настроение  2)  празднество, торжества
convivial	1) праздничный, пиршественный  2) компанейский, любящий выпить и закусить с друзьями
considerably	значительно, много
considerate	1) внимательный, тактичный, заботливый  2) умышленный, обдуманный, серьезный
compassion	1) сочувствие, жалость  2) сжалиться над кем-л  3)  относиться с состраданием, жалеть
compassionate	1) сострадательный, сочувствующий, жалостливый  2)   предоставляемый по исключительным,  семейным обстоятельствам   3) относиться с состраданием, сочувствием, жалеть
compassionately	сочувственно, с состраданием
amiability	1) благожелательность, дружелюбие, любезность  2) приветливость, мягкость, добродушие  3) милые слова, комплименты
amiably	дружески, любезно, мило, приветливо
amicableness	дружелюбность
amicable	1) дружественный, дружелюбный  2)  мирный, полюбовный
conscientiousness	1) добросовестность  2) сознательность
conscientiously	добросовестно, честно
conscientious	добросовестный, честный, сознательный, добросовестно относящийся 
amiable	1) любезный, благожелательный, дружелюбный  2) симпатичный, привлекательный, приятный, милый
affectionately	1) нежно, ласково  2) с любовью
affectionate	любящий, нежный, ласковый
affable	приветливый, учтивый, любезный
adaptable	1) легко приспособляющийся, адаптирующийся  2) умеющий происпосабливаться к новой обстановке, чужим людям и т. п.  3) поддающийся адаптации, переделке  4) подходящий, пригодный
confront	1) стоять против  2) встретиться лицом к лицу  3) столкнуться  4) сталкивать   5) противостоять, смотреть в лицо   6)  конфронтировать, делать очную ставку  7)  предъявлять  8) сравнивать, сопоставлять, сличать
receptive	1) восприимчивый  2)  рецептивный
opposed	1) противный, противоположный   2) встречающий сопротивление  3) враждебный 
eligible	1) могущий, имеющий право быть избранным  2) подходящий, желательный, приемлемый  3)  подходящий в качестве мужа
astonishment	1) удивление, изумление  2) то, что вызывает удивление
astonishing	удивительный, изумительный
astonished	1) изумленный  2) пораженный
astonish	удивлять, изумлять
accustomed	привычный, обычный
intense	1) сильный, глубокий, значительный  2) напряженный, интенсивный  3) впечатлительный, эксцентричный  4)   интенсивный
wildly	дико
wearily	1) утомительно, скучно, нудно  2) устало
weakly	1) хилый, болезненный, хрупкий   2) слабый, неустойчивый   3) слабо
vivacious	1) живой  2) оживленный
vivacity	1) живость, оживленность, бодрость, веселость, жизнерадостность  2) веселье, оживление  3) яркость   4)  живучесть, долголетие
vivaciously	оживленно
violently	1) очень, сильно  2) неистово, яростно  3) жестоко, бесчеловечно
victoriously	1) победно, победоносно  2) тоном победителя
truthfully	1) правдиво  2) верно, правильно
tightly	1) туго  2) крепко, накрепко  3) плотно, без зазоров  4) плотно, тесно  5) до краев, тесно  6) напряженно  7) строго  8)  глубоко, основательно, энергично  9)  опрятно
thoroughly	1) вполне, совершенно, до конца  2) тщательно, как следует
tensely	1) напряженно, с напряжением  2) возбужденно, в состоянии нервного возбуждения, напряжения
tenderly	1) нежно, мягко, ласково, любовно  2) чутко  3) осторожно
swiftly	быстро, поспешно
suspiciously	подозрительно, с подозрением
stupidly	тупо
sternly	круто
stealthily	1) украдкой  2) исподтишка  3) тайно  4) втихомолку
speedily	1) поспешно, скоро, быстро, проворно  2) своевременно, без задержки
solemnly	торжественно
softly	1) мягко, нежно  2) тихо
smoothly	1) гладко, ровно, плавно  2) хорошо, гладко, благополучно
sleepily	1) сонно  2) вяло  3) лениво
silently	1) молча  2) потихоньку
shyly	1) застенчиво  2) робко
sharply	1) резко  2) внимательно
sensibly	1) разумно, благоразумно  2) ощутимо, заметно
selfishly	эгоистично
safely	1) благополучно  2) надежно  3) без риска, безопасно
rudely	1) оскорбительно, нагло, грубо  2) примитивно, топорно  3) сильно, резко, внезапно  4) приблизительно, грубо
rightfully	1) справедливо  2) законно  3) правильно
repeatedly	неоднократно, часто, повторно
reluctantly	1) неохотно  2) с неохотой  3) без желания
reluctance	1) нежелание, неохота, нерасположение, отвращение  2)  магнитное сопротивление
reckless	1) безрассудный, опрометчивый, беспечный, беззаботный  2) дерзкий, отчаянный, неосторожный, безответственный  3)  пренебрегающий 
recklessly	азартно
quietly	1) тихо, бесшумно  2) мирно, спокойно
quickly	быстро, скоро, поспешно, незамедлительно
punctually	пунктуально, точно
promptly	1) быстро, немедленно, срочно, безотлагательно  2) точно, своевременно
powerfully	1) крепко, мощно, сильно  2) сильно   3) веско, значительно
poor	1)   бедные, бедняки, беднота, неимущие  2) бедный, неимущий, малоимущий  3) бедный, несчастный  4)  покойный, умерший  5)  скромный, жалкий, ничтожный  6) незначительный, небольшой, жалкий  7) недостаточный, скудный, плохой  8)  бедный, скудный   9) плохой, низкого качества, скверный 
politely	вежливо, любезно, обходительно
perfectly	1) совершенно, вполне  2) прекрасно, великолепно, превосходно
patiently	терпеливо
painfully	болезненно, мучительно
openly	1) открыто, откровенно  2) публично, общеизвестно
obediently	послушно, покорно
obedient	1)  послушный, покорный человек  2)  послушник  3) послушный, покорный
noisily	шумно, громко, с грохотом
nervously	1) нервно  2) нервозно  3) нервически
neatly	1) аккуратно, опрятно  2) четко, ясно  3) ловко, проворно, искусно, умело
mysterious	таинственный, непостижимый
mortality	1) смертельность, летальность   2) смертность  3) падеж   4)   человечество, смертные, род человеческий  5)  смерть
madly	1) как сумасшедший, как душевно больной  2) безумно, бешено, исступленно  3) безрассудно, ветрено
loudly	1) громко, громогласно  2) шумно  3) кричаще, ярко, пестро
loosely	свободно и пр.
lazily	лениво, медлительно
kindly	1) добрый, мягкий, добродушный, дружелюбный, отзывчивый  2) мягкий, приятный, благоприятный, благотворный  3) благоприятный  4)  законный  5) доброжелательно, благожелательно, сердечно, любезно, благосклонно  6) любезно   7)  естественно, легко, без напряжения  8) сердечно  9)  с благодарностью
justly	1) справедливо, законно  2) справедливо, заслуженно  3)  верно, правильно
joyously	1) радостно  2) весело
inquisitively	1) пытливо, любознательно  2) из любопытства
innocently	невинно, наивно
hurriedly	торопливо, поспешно, наспех, кое-как, на скорую руку
hungrily	как голодный, жадно, с жадностью
hastily	1) поспешно, торопливо, наспех, второпях  2) опрометчиво, необдуманно  3) запальчиво, вспылив, в сердцах
happily	1) счастливо, весело  2) к счастью  3) успешно, удачно, благополучно, уместно, вовремя
greedily	1) жадно, с жадностью, алчно  2) с рвением
gracefully	1) грациозно, изящно  2) приятно, элегантно  3) вежливо, прилично
gladly	1) с удовольствием  2) с радостью  3) охотно  4) радостно
gently	1) мягко, тихо, спокойно, кротко, нежно  2) легко, осторожно  3) отлого
generously	1) великодушно, благородно  2) щедро
frantically	неистово, бешено, безумно
frankly	прямо, открыто, откровенно
foolishly	1) глупо  2) бессмысленно  3) нелепо
fondly	1) нежно, любовно, с любовью  2) безрассудно, излишне доверчиво
fiercely	1) свирепо, люто, жестоко  2) неистово, сильно, неудержимо, горячо
fatally	1) фатально, роковым образом, неизбежно  2) пагубно, смертельно
faithfully	1) верно, честно  2) точно 
equally	1) поровну  2) в равной степени, равным образом, одинаково
enthusiastically	восторженно, с восторгом, с радостью, с энтузиазмом
enormously	чрезвычайно, крайне, очень
hearty	1) крепкий, здоровый парень, особ. матрос  2)   студент, занимающийся спортом  3) искренний, сердечный  4) дружеский, теплый, радушный  5) здоровый, крепкий, энергичный  6) сильный  7) обильный, плотный   8) плодородный   9) крепкий 
elegantly	1) элегантно  2) модно
eagerly	1) с нетерпением  2) горячо
doubtlessly	1) несомненно  2) бесспорно
doubtfully	сомнительно
cruelly	1) жестко, безжалостно, бессердечно  2) мучительно
courageously	смело, отважно, храбро
closely	1) близко  2) тесно, плотно  3) внимательно
clearly	1) звонко, отчетливо  2) отчетливо, ясно  3) понятно, ясно
cheerfully	1) бодро, весело  2) охотно, с готовностью
cautiously	1) осторожно  2) осмотрительно
carelessly	1) небрежно, невнимательно, кое-как, неосторожно  2) беспечно, беззаботно, легкомысленно  3) без умысла, нечаянно
carefully	1) осторожно, с большой осторожностью, осмотрительно  2) тщательно, внимательно  3) точно, аккуратно
composure	спокойствие, самообладание, хладнокровие
equanimity	хладнокровие, невозмутимость, спокойствие, самообладание
calmly	1) спокойно  2) хладнокровно
busily	1) деловито  2) энергично  3) навязчиво
brightly	ярко и пр.
bravely	1) храбро  2) отважно
boldly	1) смело  2) нагло  3) круто
blindly	1) безрассудно  2) машинально
awkward	1) неуклюжий, неловкий, нескладный  2) неудобный  3) неловкий, неудобный, затруднительный  4)  опасный, трудный   5) часам
awkwardly	1) неуклюже, неловко, нескладно  2) неудобно, затруднительно
anxiously	1) с волнением, тревожно, беспокойно  2)  очень, чрезвычайно
angrily	сердито, гневно
accidentally	случайно, нечаянно, без умысла
formerly	прежде, раньше, некогда
awfully	1)  ужасно, очень, крайне  2)  ужасно, страшно
badly	1)  больной  2)  сожалеющий   3)  грустный, подавленный  4) плохо и пр  5)  очень сильно, интенсивно, крайне  6) с сожалением, тяжко 
be badly off	1) нуждаться  2) быть в трудном положении
decidedly	1) решительно, окончательно  2) бесспорно, явно, несомненно
go deeply into	углубляться
deeply	1) глубоко, на большую глубину, на большой глубине  2) серьезно, глубоко, сильно, очень  3) низким голосом, на низких нотах  4) концентрированно, густо   5) искусно  6)  как компонент сложных слов
intensely	1) сильно, очень, чрезвычайно  2) с напряжением, напряженно, внимательно
purely	1) чисто  2) целомудренно, непорочно  3)  вполне, целиком, совершенно  4) только, лишь, просто, исключительно  5)  весьма, чрезвычайно
utterly	крайне, чрезвычайно, совершенно
wriggle out	1) отвертеться  2) вывертываться
wriggle	1) изгиб, извив  2) изгибание, выгибание   3) извиваться , изгибаться, корчиться, дергаться  4) извивать, изгибать  5) пробираться ползком  6)  втереться, примазаться   7)  ускользать, увиливать
wreck	1) крушение, авария, катастрофа, гибель   2) гибель, крушение , крах   3) остов или обломки погибшего судна, остатки кораблекрушения, выброшенные морем, затонувшее судно  4) обломки   5) развалина  6) вызывать аварию, крушение, катастрофу, гибель , повреждать, выводить из строя   7) подрывать, губить   8) потерпеть аварию, крушение  9) потерпеть крах, рухнуть  
wobble	1) качание, шатание, пошатывание  2) дрожание  3) проявление нерешительности, колебание  4)  неровный ход, неустойчивое движение, виляние передних колес  5)  качание частоты, биение, вобуляция  6) качаться, шататься, вихлять  7) проявлять нерешительность, колебаться  8)  раскачивать, шатать  9) дрожать 
wink	1) моргание, мигание  2) подмигивание  3) миг   4) моргать, мигать  5) мигать, мерцать   6) подмигивать, перемигиваться  7) закрывать глаза , смотреть сквозь пальцы  8) приходить к концу, угасать, меркнуть   9)  сигнализировать светом 
whirl	1) кружение, обороты,  оборот  2) вихрь, вихревое движение, завихрение, водоворот  3) суматоха, водоворот   4) разброд, неразбериха  5) смятение   6) попытка  7)  блок для шнура  8) вертеть, кружить, вращать  9) вертеться, кружиться, вращаться 
wail	1) вопль  2) завывание, вой  3) громкий плач, рыдание, причитание, стенания  4) вопить, стонать  5) выть, завывать  6)  сетовать, жаловаться  7) оплакивать, причитать, стенать  8)   играть на джазовом инструменте
tug	1) рывок, дерганье, тянущее или дергающее усилие  2) усилие, напряжение сил  3) влияние, сильное воздействие  4) буксирное судно, буксир  5) постромка, лямка, гуж  6) дужка   7)   стипендиат  8) состязание, соревнование  9) тащить, тянуть с усилием 
trace	1)   след, отпечаток   2)   следы, остатки , признаки  3) знак, результат, последствия  4)  энграмма, отпечаток в сознании  5) чуточка, капелька, небольшое количество  6) примесь, привкус, призвук и т. п.  7)   следы в анализе, очень малые количества вещества  8)  исхоженная тропа  9)  стезя 
tire out	1) выматывать  2) умаять  3) уморить  4) натрудить
tingle	1) пощипывание  2) трепет, дрожь  3)  зуд, покалывание  4)  звон в ушах  5) ощущать звон, шум , испытывать покалывание , испытывать зуд, боль  6) вызывать шум, звон , покалывание, пощипывание, зуд, боль  7) гореть   8) вызывать ощущение покалывания, жара и т. п., жечь  9) дрожать, трепетать 
tickle	1) щекотание, щекочущее прикосновение  2)  легкое прикосновение битой к мячу, щекотание   3) приятное ощущение  4)  ненадежный, капризный  5)  неустойчивый, непрочный, шаткий, легко приводимый в движение  6)  трудный, щекотливый  7)  тонкий, чувствительный  8)  щепетильный, привередливый, разборчивый  9)  пугливый  
thaw	1) оттепель, таяние  2) потепление , сердечность  3) оттепель, послабление, либерализация   4) таять, оттаивать  5) освобождаться от льда или снега в результате таяния  6) размораживаться  7) смягчаться, оттаивать, становиться сердечней, дружелюбней  8) топить, растапливать, превращать в жидкость  9) размораживать 
tempt	1) уговаривать, склонять, подбивать, соблазнять  2) заманивать  3) соблазнять, искушать, прельщать  4)  испытывать, искушать  5)  проверять, испытывать
tame	1) прирученный, ручной, укрощенный  2) одомашненный, домашний   3) неопасный, спокойный   4) ручной   5) культурный, культивируемый, садовый  6) безопасный, безвредный, укрощенный   7) мягкий, нестрогий  8) послушный, покорный, пассивный, бесхребетный, беззубый  9) послушный, следующий предписаниям 
stroke	1) удар  2)  припадок, приступ, удар, паралич   3) взмах, отдельное движение или усилие  4) прием, ход  5) неожиданный случай  6) штрих, мазок  7) черта  8)  дробь, косая черта  9) бой часов 
strip	1) длинный, узкий кусок, лента, полоска  2)  штрипс  3) полоса , участок  4) рассказ в картинках  comic strip, strip cartoon)  5)  планка  6)  прокладка  7)  полоса, лента, полосовое железо   8)  взлетно-посадочная полоса   9)  дорожка  
stitch	1) стежок  2) шов , строчка  3) петля   4) вязка, род ручного вязанья  5)  переплетение   6)  малость, немножко  7)  минимум одежды  8)  шов  9) острая боль, колотье в боку   
steer	1)   совет, намек  2) рулевой  3) штурвальный   4)   подставное лицо  5) пособник, заманивающий жертву, зазывала   6) править, управлять рулем  7) слушаться руля, управления  8) следовать , держаться   9) направлять, руководить 
stain	1) пятно  2) позорящий факт, пятно  3) краситель, краска, красящее вещество  4) протрава, морилка   5) пятнать, покрывать пятнами, пачкать  6) покрываться пятнами, пачкаться  7) позорить, пятнать   8) красить, окрашивать  9) краситься, окрашиваться 
squeal	1) пронзительный крик, вопль, визг  2)  донос  3) пронзительно кричать, вопить, визжать  4) издавать визгливые, резкие звуки  5)   доносить, быть доносчиком, стучать на кого-л.  6)  жаловаться, протестовать 
squeak	1) писк  2) скрип  3)  шанс, случай  4)  спасение , избавление  5)  сержант  6)   солдатня  7) пищать, повизгивать  8) пропищать   9) скрипеть 
sprout	1) отросток, росток, побег, глазок   2)  рассада   3) брюссельская капуста   4)  отпрыск, потомок  5)  сынок, дочка  6) пускать ростки, давать побеги, распускаться, расти, вырастать   7) выращивать, проращивать  8) прорастать   9) отращивать 
spot	1) пятно, пятнышко  2) крапинка  3) зайчик, световое пятно  4) место, местность, район  5) место, область чувств  6) позор, бесчестье, позорное пятно  7) прыщик  8)   сыпь  9) очко  
spare	1) запасная часть   2) запасная шина  3)  запасной игрок  4) что-либо имющееся про запас, дубликат, запасной ключ, запасная смена белья  5) запасной, запасный, резервный, дополнительный  6) лишний  7) скудный, скромный, умеренный  8) строгий  9) худой, тонкий, тощий, худощавый  
soothe	1) успокаивать, утешать, умиротворять  2) умерять, смягчать  3) потакать, ублажать, поощрять, тешить
soak	1) намокание, набухание  2) жидкость для пропитывания или намачивания  3) чан для замачивания  4) просачивание воды сквозь почву  5) заболоченное место  6)  пьяница, алкоголик  7)  запой  8)  заклад  9) мочить, замачивать, пропитывать, насыщать 
snore	1) храпение  2) храп  3) храпеть, похрапывать  4) прохрипеть, проспать  
sip	1) глоток, небольшое количество  2) пить маленькими глотками, потягивать   3) пробовать, отведывать  4) собирать мед   5) набираться   6) впитывать, глотать 
scrub	1) кустарник, кустарниковые заросли  2) поросшая кустарником местность  3) скраб, австралийские вечнозеленые заросли или леса  4)  захолустье, глушь  5) щеточка  6) колючие усы, усы щеточкой  7) чахлое или карликовое растение  8) мелкое, недоразвитое животное, заморыш  9) ублюдок, помесь 
scribble	1) небрежный или неразборчивый почерк  2) что-либо небрежно или неразборчиво написанное, каракули, мазня  3) небрежно или быстро писать  4) выводить каракули, закорючки  5) марать, пачкать бумагу, быть писакой, стихоплетом и т. п.  6)  грубо чесать 
rinse	1) полоскание  2)  умывание  3)  питье, напиток  4) нестойкая краска для волос, оттеночный шампунь  5) полоскать  6) смывать, промыать, выполаскивать  7)  запивать   8) слегка подкрашивать волосы, придавать волосам какой-л. оттенок
rejoice at	1) радоваться  2) наслаждаться
rejoice	1) радовать  2)  радоваться  3)  с гордостью носить 
radiate	1) лучистый, расходящийся лучами  2) звездообразный  3) окруженный сиянием   4) излучать , испускать   5) излучаться  6) сиять, лучиться   7) расходиться лучами, исходить из одной точки   8) распространять
question	1) вопрос   2) запрос, наведение справок  3) задание, тест  4) проблема, дело, задача, обсуждаемый вопрос  5) сомнение, возражение  6) возможность, шанс  7) допрос, следствие, расследование  8)  пытка  9) спрашивать, задавать вопрос, ставить вопросы, вопрошать уст. 
puncture	1) укол, прокол, пункция  2) прокол   3)  пробой   4) точечное отверстие  5)  укус, ужаление  6) прокалывать, пробивать отверстие  7) получить прокол  8) уколоть  9) татуировать 
conscious	1)  сознание, сознательная психическая деятельность  2) сознающий, понимающий  3) осознанный, сознательный  4) ощущающий  5) predic находящийся в сознании  6) здравый, мыслящий  7)  как компонент сложных слов со значением: осознающий  8) тонко чувствующий, чувствительный 
consciously	1) сознательно, осознанно, с сознанием  2) преднамеренно, умышленно
conscience	совесть
prick	1) шип, колючка, игла  2) укол, прокол  3) угрызение  4) острие, игла для прочистки, шило  5)  стрекало  6) точка, след   7)  заковка   8) след зайца  9)  виток табака 
preserve	1)   варенье, презервы, консервы  2) охотничий или рыболовный заповедник  3) что-либо предназначенное для ограниченного круга людей  4) защитные очки  5) сохранять, оберегать  6) хранить   7) хранить, коптить  8) охранять   9) разводить 
precedently	прежде, раньше, в прошлом
precede	1) предшествовать  2) быть, находиться или идти впереди  3) предпосылать  4) превосходить, быть выше по положению, должности, званию и т. п.  5) превосходить по важности
preach	1)  проповедь  2) проповедовать, читать проповедь  3) проповедовать, выступать в защиту   4) поучать, читать нравоучения, наставления 
pop	1) отрывистый звук, хлопанье, хлопок, щелк, щелчок, треск  2) выстрел  3)  пистолет, револьвер  4) шипучий напиток  5) легкий  мяч  pop fly)  6) след легкого быстрого прикосновения  7)  заклад  8)  хлопок    9) хлоп, с шумом, с треском 
polish	1) полировка, шлифовка, отделка  2) лоск, глянец  3) полировка, полированная поверхность  4) политура, полировальный состав  5) лак, крем, мастика  6) лоск, изысканность , внешний блеск  7) тонкость, изысканность, совершенство   8)  гладкая поверхность сброса, зеркало скольжения  9) полировать, шлифовать, наводить лоск, глянец 
peck	1) пек  2) множество, масса, куча  3) клевок  4) легкий поцелуй  5) след клевка, укола, дырочка, углубление  6)  пища, харч  7) клевать, долбить клювом  8)  легко поцеловать, клюнуть  9) выклевывать, продалбливать дырку 
paddle	1) гребок, байдарочное весло  2) байдарка  3)  медленная гребля  4) лопасть или лопатка , плица  5) лопатка, мешалка  6) валек   7) палка, трость   8)  от paddle-boat колесный пароход  9)  от paddle-wheel гребное колесо 
awe	1) благоговейный страх, трепет, благоговение  2) трепет, глубокое почтение и страх  3)  внушать благоговение  4)  пугать, внушать ужас
owe	1) быть должным, задолжать   2) иметь моральный долг , быть в долгу   3) испытывать какое-либо чувство  4) приписывть   5) быть обязанным  
overflow	1) переливание через край  2) переполнение  3) разлив, наводнение  4) избыток  5)  наплыв из формы  6) водослив  7)  переливная труба  8) переливаться   9) разливаться, заливать, затоплять 
offend	1) обижать, оскорблять  2) оскорблять, вызывать раздражение, отвращение  3) вызывать, причинять боль, действовать на нервы, раздражать  4) нарушать , погрешить   5)  совершить проступок, преступление  6)  сбивать с пути истинного, соблазнять  7)  служить камнем преткновения
offendedly	с обидой, оскорбленно
note down	1) записывать  2) заносить  3) делать заметки
note	1) заметка, запись  2) примечание, сноска, ссылка  3) записка, короткое личное письмо  4) письменное уведомление  5)  нота  6)  накладная  7) расписка  8)   долговая расписка, простой вексель  9)  нота, тон 
nest	1) гнездо  2) выводок  3) стая, рой   4) родное гнездо, свой дом, пристанище, кров, прибежище  5) уютный уголок, гнездышко  6)  притон  7) шайка, сборище, банда, гнездо  8)  группа  9)  комплект предметов, вставляющихся в одно вместилище или друг в друга 
mug	1) кружка  2) прохладительный напиток  3)  морда, рыло, харя  4)  рот  5)  гримаса  6)  гримасничать  7)   переигрывать  8)   фотографировать   9)   нападать сзади, обхватывая шею рукой, схватить сзади за горло  
muddle on	действовать наобум, без плана
muddle along	действовать наобум, без плана
muddle about	болтаться, бесцельно возиться, мешкать
muddle	1) неразбериха, беспорядок  2) путаница, каша в голове  3) смешанное общество, компания  4)  путать, смешивать, вносить беспорядок, нарушать порядок  5) портить, делать кое-как  6) возиться , копаться  7) смущать, сбивать с толку, путать , помрачить , пьянить, одурманивать  8) делать речь нечеткой  9) мутить, загрязнять  
moor	1) моховое болото, заболоченная местность  2) местность, поросшая вереском  3) охотничье угодье  4)  ставить или становиться на мертвый якорь, ставить или становиться на два якоря, швартоваться  5)  крепить , пришвартовывать 
Moor	1) марроканец, марроканка  2)  мавр, мавританка  3) мусульманин
meddlesomeness	1) навязчивость  2) надоедливость
meddlesome	вмешивающийся не в свои дела, надоедливый, назойливый, навязчивый, сующий всюду свой нос
meddle in	впутываться
meddle	1) вмешиваться, соваться не в свое дело  2) трогать то, что не положено 
label	1) ярлык, этикетка, бирка, наклейка  2) ярлык, клеймо, постоянный эпитет или прозвище  3)  фабричная марка   4) помета   5)  слезник  6)  алидада-высотомер  7)   кодицил, дополнение к завещанию  8)  меченый атом  9) прикреплять ярлык, этикетку, наклеивать, приклеивать, навешивать бирку  
itch	1) зуд  2)  чесотка  3) непреодолимое желание, жажда , стремление , страсть, вожделение  4) чесаться, зудеть, свербеть  5) испытывать зуд, непреодолимое желание  6) вызывать зуд  7) досаждать, раздражать 
hum	1) жужжание  2) гудение, гул, глухой шум, рокот, рокотание  3) нестройный шум, ропот  4) мурлыканье, напевание  5) хмыканье  6)  фон, помехи,  7) жжужать  8) рокотать, гудеть  9) хмыкать, гмыкать 
hover	1) парение, свободный полет  2) ожидание, неопределенное положение, состояние неопределенности, подвешенное состояние  3)  нависший берег, яма под берегом   4)  брудер, элевеза  5) парить   6) парить, кружить, зависать, находиться в режиме висения   7) нависать, окутывать   8) нависать, застывать   9) нависать, угрожать  
heap	1) куча, груда  2)  масса, уйма, множество  3)  старый автомобиль, драндулет, колымага  4)  отвал, терриконик   5) нагромождать, складывать, сваливать в кучу   6) накапливать, скапливать   7) накапливаться, собираться в кучу   8)  нагружать, наполнять  9) сыпать, осыпать 
haunt	1) часто посещаемое, любимое место  2) убежище, пристанище, приют  3)  частое посещение   4) место кормления или логовище животных, птиц и т. п.  5) притон  6)  место, посещаемое привидениями  7)  привидение  8)  привычка, обыкновение  9) часто посещать, навещать , часто бывать  
hang	1) вид, способ подвески, манера  2)  общий смысл, значение, суть  3) склон, скат, наклон  4) склонность, предрасположение  5) пауза, перерыв, остановка, заминка, замедление  6)  то, что свисает, висит  7)  вис   8) вешать, подвешивать, развешивать  9) висеть 
hand	1) рука, кисть руки  2) лапа, передняя нога  3) лапа  4) клешня  5) указатель  6) сторона, направление, положение  7) источник  8) стрелка  9) крыло 
groan	1) стон  2) глухой треск, скрип  3) гул неодобрения, недовольства , бормотание, ворчание, жалоба  4) стонать, тяжело вздыхать, охать  5) выражать недовольство, ворчать, охать  6) томиться, стонать под гнетом , страдать под тяжестью  7) ломиться под тяжестью  8) со стонами, со вздохами рассказывать  9) скрипеть под тяжестью 
grin	1) оскал зубов, усмешка  2) ухмыляться, широко улыбаться, скалить зубы  3) выражать улыбкой  4) оскалиться  5)  просвечивать, проглядывать 
grease	1) топленое сало, жир  2) смазочное вещество, густая, консистентная смазка  3)  лесть  4)  взятка  5)  мокрец, подсед   6)  жиропот  7) сало    8) смазывать, намазывать  9) замасливать, засаливать 
fancy	1) фантазия, воображение  2) воображаемый, мысленный образ, иллюзия, мечта  3) прихоть, каприз  4) вкус, склонность, пристрастие  5) понимание,  вкус  6)   энтузиасты, любители, болельщики  7) причудливый, затейливый, прихотливый, фантастический  8) орнаментальный, украшенный, фасонный  9) фигурный, непростой 
deploy	1)  развертывать  2)  развертываться, расчленяться  3) размещать   4) запускать 
empty	1) порожняя тара  2) порожний вагон, грузовик  3)   порожняк  4) пустой, незаполненный, порожний  5) необитаемый, нежилой   6) без груза, порожний   7)  без нагрузки, холостой  8)  вакантный, незанятый, незаполненный  9) пустопорожний, бессодержательный 
drip	1) капанье, стекание капель  2) there is a drip of rain from the eaves с карнизов капает  3) капель  4) шум падающих капель  5) капля  6)  капеж  7)  слезник, отливина  8)  капельное внутривенное вливание  9) капать, стекать 
dust	1) пыль  2) пылинка  3) щепотка  4) туча, облако пыли  5) шум, суматоха  6) прах, бренные останки, тлен  7)  деньги, звонкая монета  8)   мука  9)  пыльца 
curl	1) локон, завиток  2) вьющиеся волосы  3) завивка  4) завиток, спираль  5) завихрение, вихрь, вихревое кольцо, кольцо дыма  6) курчавость  7)  вихрь, ротор  8) гребень разрушающейся волны   9) завивать, крутить, закручивать 
curve	1)  кривая  2) изгиб, поворот, излучина  3) вираж  4) кривая  5) график, диаграмма  6) кривизна, изогнутость  7) лекало  8) круглые скобки  9)  финт  
concern	1) отношение, касательство  2) беспокойство, забота, тревога  3) участие, интерес  4) дело, фирма, предприятие, концерн  5) доля, пай, участие  6) важность, значание  7)  дела  8)   вещь, штука  9) касаться , описывать 
clip	1) зажим, скрепка  2) скрепа, скоба  3) зажимные клещи, щипцы  4) клипс   5)  обойма  6) зажимать, сжимать, захватывать  7) скреплять   8) стрижка  9) настриг шерсти 
choke	1)  сердцевина артишока  2) удушье, припадок удушья  3) удушение  4) то, что душит  5) завязанный конец   6)  воздушная заслонка, дроссель  7)  дроссельная катушка  8) душить  9) задыхаться 
bump	1) глухой удар, столкновение  2) шишка, выпуклость  3) шишка   4)  способность  5)  воздушная яма,   болтанка  6)  вскипание с толчками  7)  вихляние тазом, эротическое движение в танце   8)  снятие с должности  9)  повышение по службе, пинок наверх 
bruise	1) ушиб, синяк, кровоподтек  2) вмятина, выбоина  3) помятость, побитость   4) оскорбление чувств  5) ушибать, подставлять синяки  6) задевать, оскорблять  7) помять, побить   8) помяться, побиться   9) толочь 
branch	1) ветка   2) ребенок, отпрыск  3) отрасль   4) филиал, отделение  5) линия, ветвь   6) рукав   7)  приток, ручей  8) ответвление   9) отрог  
brake	1) тормоз  2) рукоятка   3) тормозить  4)  папоротник   5) чаща, заросли кустарника  6) трепало   7) тестомешалка  8) большая борона  9) мять, трепать  
bow	1) лук   2) лучники, стрелки из лука  3) что-либо имеющее форму дуги  4)  арка  5) радуга  6) смычок  7) удар смычка  8) лучок дрели или пилы  9) седельная лука, арчак 
boreal	 бореальный, северный, арктический
bore	1) высверленное или расточенное отверстие  2)  скважина, шпур  3)  канал ствола  4)  калибр оружия  5) сверлить, растачивать  6) поддаваться сверлению  7) бурить  8) с трудом прокладывать себе путь, протискиваться  9) вытягивать голову  
boast	1) хвастовство, похвальба  2) предмет гордости  3) хвастать, хвастаться, похваляться  4) гордиться  5) грубо обтесывать   6) удар за боковую линию   7) послать мяч за боковую линию 
blush	1) краска стыда, смущения  2) розоватый цвет или отблеск  3) багрянец, красный цвет   4) краснеть, заливаться краской от смущения, стыда, смущаться  5) смущать, вгонять в краску
blot	1) пятно  2) клякса, помарка, неясное, стершееся место в тексте  3) пятно, позор, бесчестье  4) что-л уродливое, громоздкое, неприятное для глаза  5) делать кляксы, пачкать  6) пачкаться, становиться грязным  7) стирать, вычеркивать, смазывать написанное, вымаривать  8) заглаживать  9) затмевать, затемнять, заслонять 
bleach	1) хлорная, белильная известь  2) отбеливающее вещество  3) отбеливание, беление  4) белить, отбеливать  5) обесцвечивать  6) побелеть, обесцветиться
yolk	1) желток   2) сердцевина, суть, сущность  3)  жиропот, ланолин
wig	1) парик  2) тупей  3) волосы, шевелюра  4)  должностное лицо в парике , сановник, шишка  5)  взбучка, нагоняй  6)   голова, мозги  7)   интеллигент, умник   8) надевать парик, снабжать париками   9)  давать взбучку, нагоняй, отчитывать 
wicked	1)   нечестивые, нечестивцы  2) злой, злобный, порочный, безнравственный  3) нехороший, дурной  4) склонный к озорству, проделкам, насмешкам  5)  шаловливый, озорной   6) опасный, нанесенный преднамеренно   7) плохой  8) противный, неприятный  9) свирепый  
whooping cough	 коклюш, судорожный кашель
whip	1) плеть, плетка, кнут, хлыст, розга, прут, хворостина  2) кучер  3)  парламентский партийный организатор  4)  повестка партийного организатора о необходимости присутствовать на заседании парламента  5)  выжлятник, доезжачий  6) обметка   7) взбитые сливки или яичные белки, крем  8) веничек, взбивалка  9) конный ворот 
weigh	1) взвешивать  2) взвешиваться   3) весить  4)  иметь вес, значение, влиять  5)  тщательно рассматривать, взвешивать, оценивать  6)  составлять мнение   7) сравнивать, соизмерять  8)  поднимать со дна моря  weigh up)  9)  сниматься с якоря, поднимать  
weary	1) усталый, утомленный  2) изнывающий от скуки  3) утомительный, надоедливый, скучный  4)  уставший, потерявший терпение   5)  невеселый, безрадостный  6) утомлять, надоедать  7) утомляться  8) изнывать от скуки  9)  тосковать, стремиться  
wax	1)  воск  2) минеральный воск, озокерит  3) парафин  4) ушная сера  5) мазь  6)  восковая фигура, восковая свеча  7) сургуч  8) граммофонная пластинка  9)  пластичная глина для перемычек 
wander	1)  странствие  2) бродить, странствовать  3) блуждать   4) ходить   5) заблудиться  6) отклоняться  7) заблуждаться, запутаться, сбиться  8) путаться, путать , говорить несвязно, непоследовательно  9) бредить, заговариваться 
wag	1) остряк, острослов, шутник  2) взмах  3) махать, размахивать, качать  4) качаться, мотаться  5) болтать   6) вилять   7) переваливаться, ходить вразвалку  8) двигаться, продвигаться  9)  прогульщик, лентяй 
wade	1) переход вброд  2) брод  3) переходить вброд  4) пробираться. идти с трудом   5) преодолевать что-либо  6)  войти   7) вступить , ввязаться   8) налететь, натолкнуться  9)  наброситься, накинуться 
voyage	1) путешествие , плавание, морской переход, полет, перелет, рейс   2) странствования, жизненный путь  3) книга или рассказ о путевых впечатлениях  4) путешествовать , плавать, быть в плавании, находиться в полете, совершать полет или перелет  5) блуждать, бродить 
velvet	1)  бархат  2) вельвет  3) плис  4) бархатистость, бархат  5)  выигрыш, выгода, прибыль  6) бархатный  7) бархатистый, как бархат  8) густой  
twinkle	1) мерцание  2) мигание  3) мелькание  4) огонек   5) мгновение  6) мерцать, сверкать  7) моргать, мигать, подмигивать  8) мелькать, быстро двигаться  9) излучать  
trial	1) испытание, проба  2)  испытание , опыт   3) переживание, испытание, злоключение  4) причина недовольства или раздражения  5)   следствие, судебное разбирательство, суд, слушание дела  6)  дело, слушаемое в суде, процесс  7)  попытка  8)  предварительные или отборочные соревнования   9)  разведка 
tremble	1) дрожь, дрожание  2) дрожать, трястись  3) вибрировать  4)  говорить дрожащим голосом   5) трепетать, страшиться, опасаться  6)  вызывать трепет   7) колыхаться, трепетать, развеваться  8) колебаться, дрожать  
track	1) след  2) выслеживание, преследование   3) место, где кто-л. стоит  4)  трасса  5)  направляющий рельс  6)  трек, след   7) остаток, признак, след  8) курс, путь  9) курс 
tire	1) обод колеса  2)  шина, покрышка   3)  передник  4)  одежда  5)  женский головной убор   6)  надевать покрышку  7) утомлять  8) утомлять, уставать  9) надоедать, прискучить, наскучить 
tip over	опрокидывать
tinkle	1)  звон колокольчика, звяканье, звенящий звук  2)  телефонный звонок  3) звенеть, звякать  4) звонить, бренчать  5) звонить, бить, пробить  6)  звенеть   7)  писать
thump	1) тяжелый удар   2) глухой звук от удара  3) глухой шум   4) наносить тяжелый удар  5) вбивать, выбивать, выстукивать  thump out), барабанить  6) ударяться, биться с глухим шумом  7)  избивать, колошматить, дубасить  8) тяжело, с шумом двигаться
throat	1) горло, гортань, глотка, зев  2) голос  3) горлышко, шейка , шейка   4) узкий проход, горловина  5)  горловина, зев, короткая соединительная часть , расчетный размер   6) колошник , горловина   7)  пятка   8)  жерло вулкана   9) бормотать 
thresh	1) пороть, стегать, хлестать, наносить удары  2)  побить, победить , одержать верх, потрепать   3) молотить  4) ударять, стучать , колотить   5) бить, ударять, хлестать  6) биться  7) метаться  8)  направлять судно против ветра или течения  9)  идти против ветра или течения 
thick	1) гуща  2) центр  3) разгар, пекло  4)   тупица  5)  чаща, заросли   6) толстый  7) жирный   8)  дородный, плотный, упитанный  9) имеющий такую-то толщину, толщиной в 
tender	1) няня, сестра, сиделка  2) сторож  3)  помощник, официант  4)  механик, оператор  5)  тендер  6)  посыльное судно  7)  судно-матка  8)  плавучая база  9)  вспомогательное судно 
stalk	1)  стебель, цветоножка, черешок  2)  ножка, стебелек  3) стержень  4) высокая дымовая труба  5) длинная прямая часть любого предмета, стволик пера, трубка термометра и т. п.  6) высокая подставка  7) ножка   8) тетива лестницы-стремянки  9)  вертикальная грань подпорной стенки 
tardy	1) запоздавший, опоздавший, поздний, запоздалый, опаздывающий  2) медлительный, медленный, неспешный  3) в грам. знач. нареч.: с опозданием
tap	1) пробка, затычка  2)  отверстие   3) кран   4) сорт, марка ,  напиток  5)  пивная, бар  6)  выманивание денег или подарка  7)  сверло с насечками   8)  отвод, ответвление, отпайка  9) тройник 
tan	1) дубильное корье  2) танин  3) выработанное или использованное дубильное корье   4) желтовато-коричневый цвет, цвет бронзы  5) ботинок или сапог коричневого цвета  6)  загар  7)   цирк  8) рыжевато-коричневый, желтовато-коричневый  9) дубильный 
supper	1) ужин, время ужина  2) вечер с ужином   3)   вечеря  4)  причащение, причастие   5) ужинать  6) кормить ужином
stretch	1) вытягивание, растягивание  2)  выпрямление  3)  натяжение, растяжение  4)  эластичность  5) напряжение  6) протяжение, пространство, участок, отрезок  7)  отрезок дистанции  8) промежуток времени  9)  срок заключения 
straw	1) солома  2) соломинка   3) соломка   4) соломенная шляпа  5) пустяк, мелочь  6) палевый, бледно-желтый цвет, цвет соломы    7) соломенный  8) бледно-желтый, палевый, цвета соломы  9) ненадежный, сомнительный
stove	1) печь, печка  2) воздухонагреватель  3) теплица, оранжерея  4) сушильная камера  5) грелка для ног  6) сушить   7) высаживать в теплице  8) окуривать серой  9)   от stave
stork	 аист 
pantyhose	 колготки
tights	1)  трико   2) колготки  3) трико 
stocking	чулок
stir	1) шевеление, движение  2) помешивание, размешивание  3) суматоха, суета, переполох  4) толчок, подталкивание  5)  движение   6) движение души, смутное чувство  7) шевелить, двигать  8) шевелиться, двигаться  9) мешать, помешивать, размешивать, взбалтывать  
steep	1) круча, крутизна, обрыв, пропасть  2) небо  3) крутой  4)  чрезмерный, преувеличенный  5) вздутый, очень высокий   6)  невероятный, неправдоподобный   7) погружение , пропитка, пропитывание, замочка, мочка  8)  замочная жидкость  9) ванна для пропитки, замочный чан, мочило 
state	1)  состояние, положение  2) строение, структура  3) общественное положение, особ. высокое, сословная принадлежность  4) великолепие, пышность, помпа, парадность  5) напряженное или возбужденное состояние  6) состояние  7)  корректурный оттиск гравюры  8) излагать, заявлять, формулировать  9) констатировать, утверждать 
stiffened	1) окоченевший  2) одеревеневший  3) одеревенелый
stiff	1) вексель  2) поддельная банкнота  3) поддельный чек  4) тайное письмо, секретное послание, записка переданная тайком  5) нескладеха  6) босяк, бродяга  7) зануда, сухарь  8) жадина, сквалыга  9) мертвецки пьяный человек 
stake	1) кол, столб  2) стойка, подпорка , жердь  3) веха  4)  столб, к которому привязывали осужденного на сожжение  5)  смерть на костре, сожжение заживо   6)  колья, столбы   7) небольшая переносная наковальня  8) колода для мездрения кожи  9) автомобиль с решетчатым кузовом 
squirt	1) слабая или тонкая струя, струйка  2) шприц  3) спринцовка  4) водяной пистолет   5)  револьвер  6)  нахал, выскочка  7)  паренек, постреленок  8)  самое дешевое пиво  9)  реактивный самолет 
squeeze	1) сжатие, сжимание, сдавливание  2) пожатие  3) объятие  4)  теснота, давка  5)  тусовка, сборище  6)  давление, принуждение  7) вымогательство, шантаж  8) выжатый сок  9) выжимки 
eggplant	1)  баклажан   2) красновато-лиловый цвет
aubergine	1)  баклажан   2) красновато-лиловый цвет
squash	1) мезга, размягченная масса, кашица  2) фруктовый сок   3) толкучка, теснота, толчея  4) мягкий резиновый мяч  5) сквош   6)   американский сквош  6) толпа, давка  7) что-либо мягкое, податливое  8) плюханье   9) хлюпанье, чавканье   
spy	1) шпион, тайный агент, разведчик  2) шпик, соглядатай  3)  лазутчик  4) заниматься шпионажем, добывать разведывательные данные  5)  следить, шпионить   6) подсматривать , высматривать что-либо  7) выслеживать, разнюхивать   8) рассматривать, исследовать, осматривать   9) подмечать, замечать 
sprinkle	1) брызганье, обрызгивание, опрыскивание, окропление  2) окраска путем пульверизации  3) красящий раствор для пульверизации  4) небольшое количество, капля  5) лейка  6)  кропило  7) брызгать, кропить, окроплять, разбрызгивать, обрызгивать, опрыскивать  8) разбрасывать, посыпать  9) уснащать 
splash	1) плеск, всплеск  2) брызги  3) брызганье  4) пятно  5)  капелька, небольшое количество   6)  эффект, выставление напоказ, сенсация  7)  пули  8)   самолет противника, сбитый над водой  9)   падение ракеты при неудачном пуске 
speckled	1) в крапинку, крапчатый  2) пятнистый  3) рябой, пестрый  4) веснушчатый  5)  пестрый, неоднородный, смешанный
speck	1) пятнышко, крапинка  2) частица, частичка, крупинка  3) крупица, капля  4) испещрять, усеивать  5) превращаться в точку   6)   ворвань  7)   жирное мясо, шпик, бекон
sparrow	 воробей  
spade	1) лопата, лопатка, заступ  2) скребок  3) совок  4) нож   5)  сошник   6) копать лопатой  7) разделывать   8)  пики, пиковая масть  9) пика, карта пиковой масти, пиковка 
sow	1) свинья, свиноматка  2) настыль, козел   3) сеять, высеивать  4) распространять, сеять  5) засеивать  6) усеивать 
sore	1) болячка,  язва, нарыв, рана, воспаление  2) синяк, кровоподтек, ожог  3) больное место   4) болезненный, чувствительный, воспаленный, больной  5) чувствительный, легкоранимый, раздражительный  6)  сердитый, раздраженный, обиженный  7) больной, тяжелый  8) горестный, тяжкий, полный горя  9) крайний, острый  
soil	1) почва, грунт  2) замля, страна  3) грязь, пятно  4) экскременты, нечистоты, отбросы  5) навоз, компост  6)  болото или ручей, где прячется загнанное животное  7) пачкать, грязнить, марать, покрывать пятнами  8) пачкаться, грязниться, мараться  9) порочить, осквернять, бесчестить 
sob	1) рыдание, всхлипывание  2) рыдать, всхлипывать  3) говорить, задыхаясь от рыданий   4) захлебываться   5) реветь, завывать 
soap	1) мыло  2)  лесть  3)   деньги , подмазка  4)    мыльная опера, многосерийная передача   5)  сентиментальная пьеса, мелодрама   6) намыливать, мылить  7) намыливаться, мылиться  8)  льстить 
sleet	1) дождь со снегом, мокрый снег, крупа  2) ледяная корка, гололед   3) идти 
slam	1) громкое хлопанье, шум   2) сильный удар  3) нокаутирующий удар   4)   строгая критика  5)  со стуком закрывать, захлопывать  6) с шумом закрываться, захлопываться  7) со стуком швырять, бросать   8) падать со стуком, стукаться  9) хлопать, стучать  
slap	1) шлепок  2) удар , пощечина, оскорбление  3)  попытка  4) порыв   5)   грим   6)  вдруг, внезапно  7)  прямо, как раз  8)  точно  9) шлепать, хлопать 
slant	1) уклон, косина, скос  2) наклонная плоскость, склон , косой срез, скат  3) косой луч  4) косая черта, дробь   культура на скошенном агаре  6)  наклонная выработка  7)   точка зрения, позиция, отношение, подход  8)   быстрый взгляд  9)   шанс, случай 
pass over	1) переправляться  2) переправлять, перевозить  3) упускать, пропускать  4) пропускать, оставлять без внимания, обходить молчанием  5) проходить  6) передавать  7) рассматривать, останавливаться   8) умереть  9) обойти  
skip	1) прыжок, скачок  2) пропуск   3)  танец  4)  бег  5)  рикошет  6) прыгать, скакать  7) прыгать через скакалку  8)  резвиться, прыгать   9) бежать вприпрыжку 
sidewalk	1)  тротуар, пешеходная дорожка  2) боковая дорожка
shiver	1) дрожь, трепет, содрогание, дрожание  2) припадок дрожи   3)  лихорадка, озноб  4) дрожать, вздрагивать, трястись, трепетать  5)  заполаскивать   6) осколок, обломок  7)  сланец  8) разбивать вдребезги  9) разбиваться 
shed	1) навес, сарай  2) шед   3) ангар, эллинг  4) гараж, депо  5) хижина  6)  юбка   7)  зев   8) укрывать под навесом, в сарае, ставить в сарай, гараж  9) проливать, лить  
shears	стрижка, ножницы
share	1) доля, часть  2) доля, удел  3) участие, роль  4) акция, пай   5)  делить, распределять  6) делить, разделять   7) пользоваться совместно  8) участвовать , делить  9) иметь долю или часть, быть пайщиком 
shade	1) тень, полумрак, прохлада  2) неизвестность  3)  сумерки, вечерний полумрак, ночная мгла   4) уединенное место, убежище, сень  5) оттенок, тон  6) отличие, нюанс  7) незначительное количество   8) тень, намек  9)    бесплотный дух, призрак 
sew	1) шить, сшивать, зашивать, пришивать  2)  брошюровать  3)  спускать воду  4)  вытекать, просачиваться  5)  ставить на мель
screw	1) винт, шуруп  2)  шнек, червяк  3)  воздушный винт, пропеллер  4)  гребной винт  5) виток резьбы  6) поворот винта  7) гребной винт  8) винтовой пароход  9) винт, прыжок винтом  
scratch	1) царапина  2)  черта, метка  3)  царапанье  4) скрип, чирканье  5) каракуля, закорючка  6)   линия старта, старт   7)  участник соревнования, не получающий преимущества при старте   8) накладка из волос, маленький парик, прикрывающий часть головы  9)  временное название кинофильма 
scrape	1) скобление, чистка  2) царапина  3) скрип, скрипение  4)  затруднение, переделка, неприятность  5)  ссора, стычка, потасовка  6) расшаркивание  7)  бритье   8) скрести, скоблить, чистить   9)  шабрить, пришабривать 
scour	1) чистка, мытье  2) промывание   3) промоина, размыв  4)  дизентерия, понос  5)  моющее средство  6) чистить, отчищать, оттирать дочиста, шабрить  7) драить, тщательно мыть и чистить   8) очищать   9)  химически очищать, обезжиривать  
scatter	1) рассеивание, разброс  2)  разбрасывание  3)  рассеяние  4)  небольшое количество   5) разбрасывать, рассыпать, раскидывать, расшвыривать  6)  рассеивать, разбрасывать  7) размещать   8) разгонять, рассеивать  9) рассеиваться, расходиться 
scarcely... when	едва... как, лишь только... как
scarcely likely	навряд ли
scarcely	1) едва, почти   2) едва, с трудом  3) едва ли, вряд ли  4) употребляется как вежливая форма отрицания или сомнения
scale	1) чаша весов  2) платформа весов  3)   весы   4) весы для взвешивания жокеев   5)  Весы    6) весить, иметь вес  7) взвешивать  8) взвешиваться  9) чешуйка 
sake	1) для, ради чего-либо, кого-либо   2)  сакэ 
sack	1) мешок, куль  2)  мешочек, пакет  3) мешок   4) мех для вина, бурдюк  5) сак  sack coat)  6)  широкое и свободное женское платье   7) платье-рубашка   8) трен, шлейф , мантия  9)  спальный мешок, постель 
rye	1)  рожь   2)  рай-виски, ржаное виски  3)  смешанное виски   4) цыган 
rule	1) правило, норма, принцип  2) привычка, обычай  3) критерий, стандарт  4) правление, владычество, господство  5)  устав   6)   территория по соседству с тюрьмой, на которой разрешалось жить некоторым заключенным   7)  постановление по конкретному делу, предписание, приказ  8) линейка, масштаб  9) правило 
rug	1) коврик, ковер  2) плед   3)  сильно тянуть, тащить с усилием, дергать изо всех сил
rubber	1) резина, каучук  2) резинка, ластик  3) аптечная резинка, резиновое кольцо для скрепления бумаг и т. п.  4)  резиновые сапоги, резиновый плащ,  галоши  5)   акции или облигации каучуковых компаний  6) шайба   7)  шина, автопокрышка  8) комплект шин, резина  9)  презерватив 
ripe	1)  берег  2) спелый, зрелый, созревший  3) выдержанный  4) зрелый, возмужалый  5)  готовый, созревший  6) подходящий, подошедший   7)  вонючий, грязный, похабный   8) спеть, поспевать, зреть  9) созревать, окончательно оформляться 
rind	1) кора   2) кожица, кожура   3) шелуха  4) корка   5) оболочка, поверхность  6) сдирать кору, снимать кожуру, очищать кожицу, срезать корку
rid	1) освобождать, избавлять  2) очищать  3) очищать от пней, расчищать, корчевать  4)   спасать   5) сбывать 
rhyme	1)  рифма  2) рифмованный стих, рифма  3) стихи, поэзия  4)  ритм   5) рифмовать  6) рифмоваться, служить рифмой  7) слагать, сочинять рифмованные стихи
reel	1) катушка   2) шпулька, бобина  3)  барабан, мотовило, ворот  4) рулон   5) рулон   6)  часть   7)  короткометражный кинофильм  8) рулетка    9) наматывать на катушку, шпульку, бобину и т. п.  
rap	1) легкий удар  2)  стук  3)  наказание, приговор, срок  4)  выговор, взыскание  5)   похвала  6) рэп  rap music)  7) слегка ударять  8) стучать, постукивать  9) выстукивать  
rake	1) грабли  2) кочерга  3) лопаточка крупье  4) расческа, частый гребешок  5) скелет, щепка   6)  скребок  7) сгребать граблями, заравнивать, подчищать граблями   8) ворошить   9) чистить скребком 
raisin	1) изюминка  2) изюм, сабза  3) лиловато-красный цвет
rag	1) тряпка, лоскут, обрезок   2)  тряпье  3)  ветошь, обтирочные концы  4) клок, клочок, обрывок, кусочек  5)  отрепья, лохмотья  6)   одежда  7)  лоскут, тряпка   8) листок, газетенка  9)  белый волокнистый пучок  
radish	1)  редис   2) редиска
quitter	1)  нарыв на ноге   2)  гной  3)   тот, кто легко пасует перед трудностями, трус  4)   лодырь, прогульщик, сачок
queer	1)  фальшивые деньги  2)  гомосексуалист  3)  что-либо странное или сомнительное  4) странный, необычный  5) странный, чудаковатый, эксцентричный  6) сомнительный, подозрительный  7) испытывающий недомогание, головокружение  8)  поддельный, подложный, фальшивый  9)  пьяный  
prompt	1) подсказка, напоминание  2)  день платежа, срок платежа, день сдачи товара и производства платежа  3) быстрый, проворный, исполнительный  4) немедленный, безотлагательный  5)  срочный, промптовый, немедленный  6)  быстро  7)  точно, ровно  8) побуждать, толкать  9) подсказывать, напоминать 
praise	1) похвала  2) восхваление  3) прославление, хвала  4)  что-либо достойное похвалы, достоинство, заслуга   5) хвалить  6) прославлять, восхвалять, превозносить  7)   оценивать
porter	1) швейцар, привратник  2)  дежурный при входе в колледж   3) носильщик , грузчик  4)  проводник   5) уборщик или подсобный рабочий   6) портер  porter's ale, porter beer)
porridge	1)  каша  2) всякая всячина, вздор 
porch	1) подъезд, крыльцо  2) паперть   3)  веранда, терраса  4)  портик, крытая галерея  5)  портик в Афинах, где занимался с учениками философ Зенон  6) философия стоицизма 
poplar	1)  тополь   2) древесина тополя  3)  тюльпанное дерево
pod	1) стручок, боб, лопатка , коробочка   2) шелуха, лузга, кожура  3) кокон   4) защитная оболочка яиц , икры   5)  защитная конструкция  6) отделяемый грузовой отсек   7)  гондола   8)  брюхо  9)  обтекатель 
plaster	1)  штукатурка , замазка, шпаклевка  2) гипс  3) пластырь  4) то, что облегчает боль, страдания  5)   масло  6)   банкнота, бумажка в один доллар  7)   закладная  8)   шпик, хвост  9)   повестка 
pit	1) яма, ямка, впадина, углубление  2)  ровик, одиночный окоп, ячейка, гнездо  3) шахта, рудник, шахтный ствол, карьер, разрез, копь  4) выемка, котлован  5) колодец, шурф  6) литейная яма  7)  смотровая канава, ремонтная яма  8) яма для хранения овощей   9) силосная яма 
recognition	1) узнавание, опознавание  2) сознание, осознание  3) признание, одобрение  4)  официальное признание , утверждение, санкция  5)  признание   6) приветствие   7)  предоставление слова  8)  обнаружение, опознавание  9)   расследование, судебное следствие  
belly	1) живот, брюхо, пузо  2)  брюхо, желудок  3) аппетит  4)  брюшко насекомого и т. п.  5) первый желудок у жвачных  6)  чрево, утроба  7)  чрево матери  8)  утолщение пласта  9)  колоколообразное включение минерала в жиле 
incept	1)  начинать , приступать   2)  поглощать
misconduct	1) дурное поведение, нарушение дисциплины,   неправомерное поведение, проступок  2)  адюльтер, супружеская неверность, неумелое, плохое выполнение своих обязанностей, особ. должностное преступление  3) дурно вести себя, нарушать дисциплину, совершать проступок  4) нарушать супружескую верность, совершать адюльтер  5) неумело, плохо выполнять свои обязанности
allegedly	по утверждению , как утверждают , будто бы, якобы
alleged	1) утверждаемый   2) сомнительный, мнимый, подозрительный, не внушающий доверия
allege	1) утверждать, заявлять   2) приводить в оправдание или в качестве объяснения, оправдывать , ссылаться   3) приводить в доказательство, в подтверждение  4)  заявлять  под присягой 
withdrawal	1) отнятие, отдергивание  2) увод  3) изъятие  4) взятие назад, отказ   5) отмена, аннулирование, снятие   6) выход   7) уход, отход  8) отодвигание   9) удаление 
pint	1) пинта   2) кружка эля, пива 
pin	1) булавка  2) шпилька , заколка   3) брошка, брошь  4) значок  5) кнопка   6) прищепка  clothes pin)  7)  гвоздь  8)  палец, штифт, шпилька, шплинт, чека  9)  шкворень, ось, цапфа, шейка, цевка, пята 
petal	лепесток
dawn	1) рассвет, утренняя заря  2) начало, начатки, зачатки, истоки  3) светать, брезжить, заниматься  4) освещаться  5) начинаться, пробуждаться, появляться  6)  осенять, приходить в голову, приходить на ум, доходить до сознания
peep	1) быстрый взгляд   2) первое появление, проблеск  3) полоска света  4) щель, просвет  5) минимум   6) заглядывать, смотреть прищурясь  7) заглядывать в маленькое отверстие, подглядывать  8)  рассматривать с любопытством, разглядывать  9) выглядывать, проглядывать, появляться  
patter	1) условный язык, социальный или профессиональный жаргон  2) скороговорка   3) речитатив  4)  слова песни, текст комических номеров, реприза  5)  пустая болтовня, трескотня  6) говорить скороговоркой, тараторить  7) болтать пустое, бессмысленно тараторить  8) говорить на жаргоне, на тайном языке   9)  говорить на  языке 
pat	1) похлопывание, хлопанье, шлепанье  2) негромкий звук, хлопок, шлепок  3) звук шагов  4) танец афроамериканцев, чечетка  5) кусок, кружочек сбитого масла   6) похлопывать , шлепать, погладить   7) приглаживать  8) оглаживать   9)  хлопать себя по коленям и притоптывать ногами в такт музыке  
pasture	1) подножный корм  2) пастбище, выгон, выпас   3) пасти скот  4) пастись
paste	1)  тесто  2) макаронное изделие  3) паста, мастика  4) паштет  5) паста  6) пастила, халва  7) состав, масса  8) клей, клейстер  9) мятая глина 
hence	1)  с этих пор, с этого времени  2) следовательно, в результате  3)  отсюда 
pass by	1) проходить мимо  2) оставлять без внимания, пропускать  3) проходить   4) быть известным 
pass between	ответить на какое-либо действие тем же действием, обменяться 
pass around	раздавать
pant	1) одышка, затрудненное дыхание  2) вздох  3) пыхтение   4) часто и тяжело дышать, задыхаться  5) пыхтеть   6) говорить задыхаясь, выпаливать   7)  страстно желать , тосковать  8) вздыматься   9) трепетать, сильно биться 
pad	1)  дорога  2)  брести, идти пешком  3)  идти или бежать неслышным шагом  4)  грабить на большой дороге   5) подушка, подушечка  6) мягкая прокладка, набивка  7)  подкладка, прокладка  8) мягкое седло  9) седелка 
pail	1) ведро, бадья  2) полное ведро  3)  посуда, в которой рабочий носит свой обед, судок
oven	1) печь, духовка  2)  сушильная печь  3) термостат
straight out	1) прямо  2) напрямик
straight off	1) сразу  2) не обдумав
straight off the ice	1) незамедлительно  2) немедленно  3) свежий  4) только что полученный
with expedition	1) незамедлительно  2) срочно
nod	1) кивок   2) клевание носом, дремота   3) кивать головой  4) клевать носом, дремать  5) зазеваться, прозевать  6) наклоняться, качаться, кивать   7) покоситься, грозить обвалом   8) быть на краю гибели, грозить рухнуть 
nibble	1) обгрызание, откусывание  2) чуточка, капелька  3) клев   4) осторожная попытка, прощупывание почвы  5) обгрызать, грызть, глодать , щипать   6)  покусывать, есть лениво, без аппетита  7) постепенно разрушать, подтачивать  8)  пробовать  9) клевать  
neat	1)  вол, корова, бык  2)  крупный рогатый скот  3) чистый, чистоплотный, опрятный, аккуратный  4) скромный и изящный, ловко сидящий   5) стройный, складный   6) четкий, ясный  7) лаконичный, отточенный   8) хорошо сделанный  9)  отличный, замечательный 
napkin	1) салфетка  2) пеленка, подгузник  3) маленькое полотенце  4)   платок 
nap	1) короткий сон днем  2) вздремнуть, дремать   3)  ворс, начес  4)  ворсковая, ворсованная ткань, ткань с начесом  5) пушок , пушистая поверхность  6)  шляпа   7)  ворсить, ворсовать  8) наполеон   9)  схватить, арестовать, задержать, поймать на месте преступления 
nail	1) ноготь  2) коготь  3) гвоздь, нагель  4)  шпилька  5)  нейл, мера длины   6)  сигарета гвоздик   7) забивать гвозди, прибивать , приколачивать  8) приковывать, пригвождать   9)  схватить, поймать, забрать, арестовать 
merchant	1) купец, оптовый торговец  2)   лавочник  3)  человек, который поступает неблаговидно, тип   4) торговый, коммерческий
matted	1) спутанный   2) покрытый густой зарослью  3) задернелый   4) сделанный из плетеного камыша или тростника  5) покрытый циновками, половиками  6) матовый, матированный 
tangle	1) переплетение  2) спутанный клубок  3) клубок, сплетение  4) путаница, неразбериха, беспорядок, сумбур, смятение  5) ссора, стычка  6)  пробка, затор   7) драга для исследования морского дна  8) спутывать, запутывать  9) спутываться, запутываться, переплетаться 
maple	1)  клен   2) древесина клена
maize	 маис, кукуруза 
maid	1) служанка, горничная, прислуга  2) девушка, девица, дева  3)  старая дева
loose	1) свободный выход, открытое проявление   2) свободный  3) несвязанный, неупакованный  4) несдержанный  5) нетугой  6) неприлегающий, широкий  7) незакрепленный, ненатянутый, болтающийся, шатающийся  8) неопределенный, неточный, расплывчатый  9) распущенный 
lock	1) локон  2) волосы  3) пучок волос  4) клок   5) замок, запор, затвор  6) замок, затвор   7) шлюз, плотина, перемычка  8) захват на ключ   9) мертвая хватка, тиски 
loaf	1) каравай, буханка хлеба, булка  2)   хлеб  3) мясной хлеб   4) голова сахару  5) кочан   6)  голова   7) образовать кочан   8) ничегонеделание, праздность  9) бездельничать, зря терять время, заниматься пустяками, слоняться, шататься без дела 
limb	1) конечность, член , рука или нога  2) нога   3) крыло птицы  4)  ветвь нервного порядка  5)  сук, ветка  6)  непослушный ребенок, неслух  7)  член предложения  8)  крыло   9) отрог горы 
widen	1) расширять, распространять  2) расширяться, распространяться
narrow	1)  узкое место , узкий проход, теснина, улочка  2)    узкий пролив , узкость, узкости  3) узкий, тесный   4) ограниченный  5) еле достаточный, минимальный  6) узкий, ограниченный   7) подробный, тщательный, точный  8)   скупой, скаредный, прижимистый  9) в грам. знач. нареч.: подробно, точно, пристально  
lid	1) крышка, колпак  2)   сторонка   3) веко  4)  шляпа, шлем  5)   ограничение, узда, запрет  6)  крышечка   7)   пакетик маврихуаны  
lawn	1) лужайка с подстриженной травой, газон  2) площадка с травяным покрытием  3) прогалина, полянка   4) батист  5) батистовые рукава 
lantern	1) фонарь  2) световая камера маяка  3)  фонарь  4)  верхний свет  5)  цевочное колесо   6) освещать фонарем или фонарями  7) повесить на фонарном столбе
fellow	1)  человек, парень, малый  2)  тип  3) товарищ, собрат  4) аспирант, стипендиат, занимающийся исследовательской работой  5) младший научный сотрудник колледжа или университета   6)  член совета колледжа, университета  7)  действительный член научного общества  8) парная вещь, парный предмет, пара  9) кто-л. равный  
lad	1) мальчик, юноша, парень, малый  2)  парень   3)  лихой, бойкий парень, молодчина. молодчага 
shoelace	шнурок для ботинок
cauldron	1) котел, котелок  2)  котлообразный провал, кальдера
pot	1) горшок, котелок,  кастрюля  2) банка  3) кружка  4) ночной горшок  5) цветочный горшок  6)  вегетационный сосуд  7) тигель   8) бак, резервуар  9)  общий котел 
kettle	1) чайник   2) котелок, котел, бак  3) котелок компаса  4)  бадья  5)  котловина  6) литавра 
kernel	1) зерно  2) зернышко   3) ядро, ядрышко  4) суть, сущность  5)  керн, сердцевина   6)  ядро  7) стержень   8) ядро, ядерное предложение
jolly	1)   матрос   2)  от jolly-boat   четверка , четырехвесельный ял, тузик  3)  увеселение, развлечение, забава  4)  празднество  5)  наслаждение, приятное возбуждение  6) веселый, радостный, живой, любящий веселую компанию, общительный  7) праздничный, шумный  8) подвыпивший, навеселе  9)  приятный, замечательный, восхитительный и т. п.  
jar	1) неприятный, резкий, дребезжащий звук  2) сотрясение, дрожание, дребезжание  3) потрясение, неприятное впечатление, шок  4) дисгармония, несогласие  5) ссора, разлад  6)  вибрация  7) издавать неприятный резкий звук  8) вызывать дрожание, дребезжание, сотрясать  9) сотрясаться, дрожать, содрогаться 
janitor	1) привратник, швейцар, вахтер  2)  уборщик, сторож, дворник
hurrah	1) ура   2) кричать ура!  3) приветствовать  криками ура!  4) ура!
hose	1) рукав, кишка , шланг, брандспойт  2) футляр, ножницы  3)  влагалище початка кукурузы  4) поливать из шланга  5)   обмануть, обдурить  6)   нанести поражение, расколошматить  7)   чулки, чулочные изделия  8)  длинные носки, получулки, носки гольф  9)  рейтузы, штаны в обтяжку, лосины
hoop	1) обод, обруч  2) обруч   3) серсо  4) гимнастическое кольцо  5) плоское кольцо   6) что-либо имеющее форму кольца, кольцо  7)  фижмы  8) юбка с кринолином  9) ворота  
honk	1) крик диких гусей  2) хрюканье  3) автомобильный гудок  4)   сигналить, гудеть  5) подавать звуковой сигнал, нажимать на гудок
gruff	1) грубоватый, резкий, неприветливый  2) угрюмый, мрачный  3) грубый, хриплый   4)  грубый, неотделанный
gruffly	1) грубо, резко  2) угрюмо  3) хрипло
gobble	1) гольф гобол   2) есть быстро, жадно и шумно   3)   хватать  4) кулдыканье  5) кулдыкать   6) бормотать, злобно ворчать
clue	1) ключ к разгадке, путеводная нить  2) улика  3)  сведения, информация  4)  сообщить о событии, раскрыть   5)  раскрыть секрет, тайну
glue	1) клей  2)  глия   3) клеить, склеивать, приклеивать   4) приклеиваться, склеиваться, прилипать   5) соединять, связывать  6)  быть неотлучно 
glossy	1) журнал на глянцевой бумаге, иллюстрированный массовый журнал  2) фотоснимок на глянцевой бумаге  3) блестящий, глянцевитый, лоснящийся, гладкий  4) скрытый, прикрытый, вполне пристойный, благовидный, обманчиво привлекательный
glance	1) быстрый взгляд  2) вспышка, блеск, сверкание  3) скользящий удар  4) упоминание, аллюзия  5) удар, при котором мяч соскальзывает с биты   6)  мельком взглянуть  7) быстро просмотреть  8) слегка затрагивать, упоминать  9) видеть, замечать мельком 
gingerbread	1)  имбирный пряник, коврижка  2) что-либо показное, пряничность, дешевая пышность, мишурность  3) пряничный, мишурный
fold	1) овчарня, загон для овец  2) отара овец  3)  паства, лоно церкви, церковь  4) свой круг, общество единомышленников, единоверцев   5) загонять , помещать  в загон  6) складка, сгиб  7) сгибание  8) кольцо   9)  фальц 
float	1) плавучая масса   2) пробка, поплавок, буек  3) поплавок гидросамолета  4) буй  5) плот, паром  6) лопасть, плица   7) пузырь   8) плавательный пояс, надувная подушка и т. п., для обучающихся плавать  9) полок, телега 
flea	1)  блоха   2)  блошка   3)  листоед, листогрыз   4) красновато-коричневый цвет  5)   скучный, надоедливый человек, зануда   6)  избавляться от блох, очищать от блох
flap	1) откидная доска стола, откидной борт, дверца люка, створка   2) клапан , пола   3) поля шляпы  4) уши, отвороты   5) легкий удар, шлепок, хлопок  6) хлопанье  7) хлопушка   8)  паника, смятение  9)   шумное сборище, попойка 
flake	1) легкий или пушистый комок, клочок   2) хлопья  3) чешуйка  4) осколок  5) слой, ряд  6)  зерно   7) двуцветная гвоздика  8) трещина в бриллианте  9) падать, сыпаться хлопьями 
guiltlessly	безвинно
guiltily	виновато, с виноватым видом
guilt	1) вина, виновность  2) сознание вины  3) преступление  4)  проступок, грех  5)  наказуемость
blame	1) порицание, упрек  2) вина, ответственность  3) обвинять, порицать, винить  4) относить за счет чего-л
fare	1) плата за проезд, стоимость проезда  2) ездок, седок, пассажир  3) пища , провизия, съестные припасы, стол  4)  улов   5) поживать, жить, быть  6) питаться, кормиться  7)  путешествовать, ехать  
faraway	1) далекий, дальний, отдаленный  2) отсутствующий, рассеянный   3) в грам. знач. сущ. далекое, дальность
fade	1)  пресный, плоский, обыденный, банальный  2) вянуть, увядать  3) выгорать, выцветать, линять, блекнуть   4) обесцвечивать   5) сливаться , расплываться   6) замирать, постепенно затихать   7) постепенно исчезать, сглаживаться  8)  постепенно расплываться   9)  становиться более четким на экране 
errand	поручение, задание
envelope	1) конверт  2) обертка, обложка  3) оболочка  4)  обшивка, кожух  5)  обечайка  6)  обмуровка  7)  огибающая   8)  колба, баллон  9)  оболочка, пленка 
envelop	1) конверт  2) обертка, обложка  3) оболочка  4)  обшивка, кожух  5)  обечайка  6)  обмуровка  7)  огибающая   8)  колба, баллон  9)  оболочка, пленка 
anyhow	1) во что бы то ни стало, в любом случае, во всяком случае, как бы то ни было  2) как-нибудь, любым путем, так или иначе  3) как попало, кое-как, спустя рукава  4) плохо, неважно
lead	1)  свинец  2) грузило, отвес  3)  лот  4)  пуля, пули, девять граммов свинца  5) свинцовые полосы для покрытия крыши  6) покрытая свинцом крыша, плоская крыша  7) графит, карандашный грифель  8)  свинец, гарт   9)  шпоны 
prodigy	1) чудо  2) необыкновенно даренный человек  3) замечательный, изумительный образец чего-либо  4)   предзнаименование
what is more	1) больше того  2) причем  3) вдобавок
dilapidated	1) ветхий, обветшалый, полуразрушенный, полуразвалившийся  2) растраченный   3) неряшливо одетый, растрепанный, растерзанный
dilapidation	1) ветшание, обветшание  2) ветхость, обветшалость, полуразрушенное состояние  3)  повреждение, нанесение ущерба недвижимой собственность  4) камнепад
dilapidate	1) приводить в упадок, вызывать обветшание, разрушать  2) приходить в упадок, ветшать, разрушаться  3) растратить, промотать 
eyesore	1) что-либо противное, оскорбительное , уродство  2) бельмо на глазу
edge	1) острие, лезвие, режущая кромка   2) острый край, острота  3) острие, острота   4) край, кромка  5) обрез   6) поле   7) бордюр  8) кряж, хребет, гребень   9) бровка  
eager	1)  страстно стремящийся , жаждущий , нетерпеливый  2)  напряженный  3) энергичный, острый
driveway	дорога, проезд, подъездная аллея
downtown	1)    деловая часть города, центр города, расположенный в деловой части города, в центре  2)    в деловой части города, в центре, в деловую часть города, в центр
downstairs	1) низ, нижняя часть здания, нижний этаж  2) прислуга   3) нижний, расположенный в нижнем этаже  4) вниз  5) внизу, в нижнем этаже  6)  на улице  7)   на небольшой высоте
doorway	1) вход в помещение  2)  дверной проем, портал  3) путь, дорога 
word	1) слово  2)  речь, разговор, слова  3)  размолвка, ссора  4) замечание, совет  5)  вести, известие, сообщение  6)  обещание, заверение  7) рекомендация, совет  8)  приказ, приказание  9) пароль, пропуск 
